OOOHOOOHOH
OHOHOHOHOH
OHOHOOOHOH
OHOHOHHHOH
OHOHOOOHOH
OHHHHHOHOH
OHOOOHOHOH
OHOHOHOHOH
OOOHGOOOOH
HHHHHHHHHH
