HHHHHHHHHHHHHHHHHHHH
HOOOHOOHHOOOOHOHOHHH
HHHOHHOOHHOHHHOHOOHH
HHOOOHOHHOOOHHOHHOOH
HOOHOOOOOOHHHOOHHOHH
HHHHHOHHHHHOOOHHHOOH
HOHHOOHOHHOOHOOHOOHH
HOHHHOOOOHHHHHOHOHHH
HOHOOOHHOOHHOHOHOHOH
HOHHHOHHHOOOOOOOOOOH
HOOOHOHOHOHOHHOHOHHH
HOHSGOOOHHHOHHOHOOOH
HHHHOHHOOOHOHOOHOHHH
HOOOOHHOHHHOHHOHOHHH
HHHHOOHOOOHHHHOHOOOH
HOOOOHHHHHHHHOOHOHOH
HOHHOOOOHHHOHOHHOHOH
HOHOOHHHHOHOHOHHOHOH
HOHHOOOOOOOOHOHHOHOH
HHHHHHHHHHHHHHHHHHHH
