HHHHSHHHHHHHHHH
HHOHOHOOOHHOHOH
HOOOOOOHOOOOOOH
HHHHOHHHHOHHHHH
HOOOOHHHOOOOOOH
HHHHHHOHOHHHHHH
HOHHOOOOOHOHOHH
HOHHHHHHOOOOOOH
HOOOHOOOOHOHOHH
HHHOHHHHOHHHHHH
HOOOOHHOOOHOHOH
HHHHOOOOHOOOOOH
HOHHHHOHHOHHHHH
HOOOOOOHHOOOOOH
HHHHHHHHHHHHGHH
