HHHHHHHHHH
HSHHOHOHOH
HOHOOOOHOH
HOHHHHOOOH
HOHOOHHHOH
HOHOHHOOOH
HOOOOOOHOH
HHOHHOHHGH
HOOHHOHHOH
HHHHHHHHHH
