HHHHHHHHHHHHHHHHHHHH
HOOOOHHOOHOHOHOOOOOH
HHOHHHHHOHOHOHOHHHOH
HOOOHOHOOOOHOOOOHHHH
HHOHHOHHHHOHOHHHHOHH
HOOOOOOHHOOOOOHHOOOH
HHHHHHOHHHOHHOOOGHHH
HOOHHOOOHHOOHHHHOHOH
HHOOHHOHHOOHHHHHHHOH
HOOHHOOOHHOOOOOOHHOH
HHOHHHHOOHOHOHHOOOOH
HOOOHOHHOOOHHHHHHOHH
HHHOOOHHOHHHHOHHHHHH
HOHHHOOSOOOOOOOOOOOH
HOHHHOHHOHHHHHHHHHHH
HOOOOOOHOOOOOOOOOOHH
HHHHOHHHHHOHHHOHHOOH
HOOOOOOOOHOOOHOHHHHH
HOHOHOHHOHOHOHOOOOOH
HHHHHHHHHHHHHHHHHHHH
