HHHHHHHHHHHHHHHHHHHHHHHHHHHHHHHHHHHHSHHHHHHHHHHHHH
HOHHOHHOHOOOHOHOOHOHHOOOOOOOOHHOHOHOOOHOHOOHOHOOOH
HOHHOOHOHHHOHOOOHHOHOOHHHHHHHHHOHOHOHHHOHHOHOHOHHH
HOHOOHHOHOOOOOHHHOOHHOOOOOOHHOOOOOOOOHHOOOOOOOOHHH
HOHHOOHOHHHHOHHOHHOHOOHOHOHHHHHOHHHHOOHOHHHHOHOOOH
HOHOOHHOHHOOOOHOHHOOOHHOHHHHOHHOOHHHHOOOOHHHOHOHHH
HOHHOHHOHHHHHOHOHOOHHHHHHHHOOOOOHHOOHOHHOOOHOHOOOH
HOOOOHHOHOHHOOHOHOHHHOHHHOHHHHHOHHOHHHHHHHOHHHHHHH
HHHHOOHOHOHHHOOOHOOOOOOOHOHOHOHOOOOOOOOOHHOHHHOOHH
HHOHHOHOHOOHHHHOOOHHHHHHHOHOHOHOHHHHHOHHHHOOOHHOOH
HOOHHOHOHOHHOOHHOHHOHHOOHOHOHOOOOOOHHHHHOHHHHHHOHH
HOHHOOOOOOOHHOOOOOOOOHHOHOHOOOHOHOHHOHHOOOHOHHOOOH
HOOHHHHHOHHHHHHHOHHHHHOOHOHOHOHHHHHOOOHHOHHOOHHOHH
HOHHOHOHOOHOHHHOOOHHOHHOHOOOHHHOOHHHHOOHOOHOHHOOOH
HOOOOOOOOHHOHOHHHOHHOHHOOOHOOHHHOOHHOOHHOHHOOOOHHH
HHHHHOHHHHHOHOOHHOHOOOOOHOHOHHOHOHHOOHHOOOOOHHHHOH
HOHOOOHHOOOOOOHHOOOOHHHHHHHHHHOOOOOOHHHHOHHHHOHHOH
HOHOHOOHHHHHHOHHHHOHHHHOHHOHOHOHHHOHHHOHOHOOHOHHOH
HOHHHOHHOHOOHOOOHHOOHOOOOOOOOOOHHHOHHOOOOHOHHOOOOH
HOOHHOOHOHHOHOHHHHOHHOHHHHHOHHHHOHHHHHHOHHOHHOHHHH
HHOOHHOHOHOOHOOHHOOOOOOOOHHHHHOHOOHHOHOOHOOOOOOOOH
HOOHHHOHOHHOHOHHHHOHHOHOHHOHOHOHOHHOOHHOHOHHHOHHOH
HOHHOOOOOHHOOOHHOHOHHHHHHOOOOOOOOOHHOHOOOOOOHOOHHH
HOHHHHOHHHHOHHHHOOOOOHOHOOHOHHHHHHHOOOOHHOHHHHOOHH
HOOHHOOOHHOOOHOHHHOHHHOHOHHHHOHOHOHOHHHHHHHOOHHOOH
HHOOHHOHHOOHHHOHHOOOHOOOOOOHOOHOHOOOOOOOOHHHOOHOHH
HOOHHOOHHOHHOHOHHHOHHOHHHHHHOHHOOOHHHHOHHHOHOHHHHH
HHOHHHOHHOOOOOOOOOOOOOOHOHHHOHHOHHHHHHHHHOOOOOOOOH
HOOOOHOHHOHHHHHHHOHHOHHHOOOOOOOOOOOOOHHOHHOHHOHOHH
HHOHHHOHOOOHHHHHHHHHHHHHOHHOHOHHHHHHOOOOOHOHHHHHHH
HOOOOHOOOHOOOOOOOHOHHHOHOHHHHOOOOOHHOHHHOOOOHHHHHH
HOHHHHOHHHHOHHHHHHOOOHOHOHOHHHOHHHHHOOHHHHHHHOHOHH
HOOHHOOOOOHOOOHOHOOHHHOHOOOOOHHHHHOHHHHOHHOHOOOOOH
HOHHOOHHHHHHHHHOHOHHOHOHOHHHHHHOOOOOOOHOHOOOOHHHHH
HOHHHOOOOOOHHHOOOOOOOOOHOOOOHOHOHHHHHHHOHOHHOOOOOH
HOOHHOHHHOHHOHOHHHHHHHOOOHHOOOOOOOOOOOOOOOOHOHHHHH
HHOOOOOOHOOOOHOOOOOHOHHHOOHHOHHHOHHHHHHHHHOHOOOOOH
HOOHHHHHHHHHHHOHHHHHOOHHHHHHHHHHHHHOHOHOHHHHHHHHHH
HHOOOOHHHHOOOOOOOOOOOHHOHOHOHOOOHOOOOOOOOOOHHHOOOH
HHOHHHHOHOOHHHHHHHHOHHOOOOOOOOHOOOHHOHOHOHHHOHOHHH
HOOHHOHOHOHHOOHOOOHHHHOHHHHHOHHOHOOHHHHHHHOHOOOOHH
HHOOHOOOOOHHHOOOHHHHOHOHOOHHHHHHHHHHHOHOHHOOOHHOOH
HOOHHOHHHHHOOOHHHHOHOHOHOHHOOOOOOOOOOOOOOOOHOOHHOH
HOHHHOOOOHHOHHHOOOOOOOOOOOOOHHHHHHHHHHOHOHOHHOOHOH
HOOOOOHHOOOOOOOOHHHHOHHHHHHHHOHHHOOHHHHHOHOHHHHHHH
HOHHHOOHHOHOHOHOOOOHHHHHHHOOOOOOHHOHOHHHHHHHOHHOHH
HOOOHOHHHHHHHHHHHHOOOOOOOOOHHHHHHOOHOOOHHOHOOOOOOH
HOHHHHHHOHOOOOOOOHHOHHOHHHHHHHHOOOHHOHHHHOHOHHHHHH
HOOOOOOOOOOHHOHHOHHOOHOOOOOOOOOOHOOOOOOOOOOOOOOOOH
HHHHHHHHHHHHHHHHHHHHHHHHHHHHHHHHHHHHHHGHHHHHHHHHHH
