HHHHHHHHHH
HOHOHOHHOH
HOHOHOHHOH
HOHOHGHOOH
HOHOHOHHSH
HOOOHOOOOH
HHHOOOHOHH
HHOOHOHOOH
HOOHHOHHOH
HHHHHHHHHH
