HHHHHHHHHH
HOOOHOHOOH
HHOHHOHOHH
HOOHHOHOOH
HOHHHOHOHH
HOOOOOOOOH
HHHOHHOHHH
HOOOHOOHOH
SOHOHHOOOH
HHHHHHHHGH
