HHHHHHHHHHHHHHHHHHHH
HOHOOHOOHOHHOHHOOOOH
HOHHOHOHHOHOOOOOHHOH
HOHOOOOHHOHOHHHOHHOH
HOOOHHHHOOOOHHOOHHOH
HHHOHHOHOHHHHHHOOHHH
HOSOHHOOOHHHOOHHHHHH
HHHOHOOHOHOHHOOHHHOH
HOOOHOHHHHOHHOHHOHOH
HOHOOOOOHOOOOOOOOOOH
HHHHOHHOOOHHHHHOHOHH
HOOOGOHOHOOOOHHHHOHH
HHHOHOHOHOHHOOOOHOOH
HOOOHOHHHOOHOHHHHHHH
HOHHHOHHOOHHOOOHOHOH
HHHOOOOHHHHHOHOOOOOH
HHOOHOHHOOOOOHOHHHHH
HOOHHOHHOHHHOHOOOOOH
HHOHOOOHOHOOOHOHOHOH
HHHHHHHHHHHHHHHHHHHH
