HHHHHHHHHHHHHHHHHHHHHHHHHHHHHHHHHHHHHHHHHHHHHHHHHHHHHHHHHHHHHHHHHHHHHHHHHHHHHHHHHHHHHHHHHHHHHHHHHHHH
HOHHOHOHOHOHHOOHHOOHOOOOHOHHOHHOOOOHHOHHOOHOHHOHHOOOOHHOHHOHHOHHOHOOOHHOHHOOOOOHHOHHOOOOOHHOHOOHOOOH
HOHOOOOOOHOOHOHHOOHHOHHHHOHHOHHOHHHHOOOHHOHOHHOHOOHOHHHOHHOOHOOHOHHOHHOOOHHHOHHHOOOHOHHHHHHOHOHHOHHH
HOHHHHHOHHOHHOHOOHHHOOHHOOOHOHHOHOOHHHOHHOHOHHOOOHHHHOHOOHHOHOHHOHOOOOOHHHHOOOOHHHOOOOOOOOOOHOOOOOOH
HOOOOOOOOHOOOOHHOHHOOHHHHHOHOHHOHOHHOOOHHOOOOHHHOHOHHOHHOHHOOOHOOOOHHHHHHOHHOHHHOHOHHHOHOHOHHOHHHHHH
HHHHHHHHOHOHHHHHOHHOHHOHOOOHOHOOOOHHHHOOHHHHOHOHOOOHOOHHOHHHHOOOHHOOOHHOHOOHOHOHOHOHHHOHHHHHHOHOOHOH
HOHOOOOOOOOHOHOHOHOOHHOHHHOHOOOHHOOHOHHOOOOOOHOOOHHHOHHOOOHOOOHOOHHHHHHOHHOHOOOHOHOOOHOHHHOOOOHOHHOH
HOHHHHHHOHHHOOOOOHHOOOOHOHOHHOHHHHHHOOOOHHHHOHOHHHHOOOHHHOHOHHHHHHOOHHOOHHOHHOHHOHOHHHHHOHHHHOOOHHOH
HOOHHOOOOOOHHHHHOHHHOHHHOHOOHOOHOHHHHHHHHOOOOOOHHOHHOHHOHOHOOOOOOHHOHHOHHOOHOOOHOOOOHOHHOOHHOOHHHOOH
HOHHHHHHOHOHHOOOOOHHOHHOOHOHHOHHOHOHOHHOOOHHHOHHHOHHOHOOHOHOHHHHHHOOHOOOHHOHHHOHOHHHHOOHHOOHHOHHOOHH
HOOHHOHOOHHHHHHOHHHHOOHHOHOHHOHHOHOHOHHHHHHHOOHHOOHOOHOHHOHOOOOOHHHOHHHOHOOHOOOOOOHOHOHHOOHHHOOHOHHH
HHOOHOHHOOHHOHOOOOOHHOHHOHOOHOOHOHOOOOOHHHOHHOHHHOOOHHOHOOOOHHHOOHHOHOHOHHOOOHHHHOOOOOHHOHHHOOHHOOOH
HHHOOOHHOHHOOOOHHOHHHOOHOHHOOOHHOHOHHHHHOOOOOOHOHHHOOHOHOHHHHHHHOHOOHOHOOOOHOOOOHOHHHHHOOOOHHOOHOHHH
HOOOHOOHOOHHHOHHHHHHOOHHOHHOHHHOOHOOOOOHHHHHHOOOHOHHOOOOOOHOOOHHHHHOHOHHHHOHHHHHHOHHOHHHOHHHHOHHOOOH
HHOHHHOHOHHOHOOHOHOHHOHHOHHOHOHHOOOHHHOHOOHOHOHOOOOOOHHHHHHOHHHOHHOOHOOOOHOHHOOHHHHHOHOHOOOOOOOOOHOH
HHHHOOOOOHHOHOHHOHOOHOHHOHHOHOOHOHHHHHHHHOHOHHHHHHHHOHOOOOHOOOHOHHHOHHHHOOOOHHOOHHOOOOOOOHOHHOHHHHOH
HOHHHHHHOHOOOOHHOHHOHOHOOHOOHOHHOOHOOOHHOOHOHHOHHOOHOOOHHHHOHHHOHOHOHHOHHOHHHHHOOHHHOHHHHHOOHOOOOHOH
HOOOOOOOOOOHOHHOOOOOOOHHOHHOOOOOOHHOHHHHHOHOOHOOHHOOOHHHHHOOHOOOHOOOHHOHHOHOHOHHOOOOOOOOHHOHHOHOHHOH
HHHHOHHHOHHHHHHHHHHHOHHOOOHHOHHHHHHOOHHOHOHHOHOHHHHHOOOOOHHOHHHOHHHOHOOHHOHOHOHOOHOHOHHHHHHHHHHHHHHH
HOHHHHOHOOHOHOHHOOOHOOHOHHHOOHHOHHOOHHOOOOHHOHOHHOHOOHHHHHOOOHHOOOHOHHOHHOOOOOOOHHOHHHOOOHHOOOOOOHHH
HOOOHOOHHOOOOOOHHHOHHOOOHHOOHHOOOHHOOHHHOHHHOHOHOOHHOOHHOHHHOHHHHOHOHHOOHOHHHHHHHHHHHHOHHHOOHHHHHHOH
HHHOHHOHHOHHOHHHHOOHHHHOOOOHHHHHOHHOHHHOOOOHOHOHHOHOOHHOOHOHOOHHHOOOOHHOHOOOOOOOHOHHOHOHOHOHHHHHOHOH
HOOOOOOHHOHHHHOOHHOOHOHHHHOHOHHOOHHOOOHHOHHHOHOHHOHHOHOOHHOHOHHOHHHHOHOOOOHHHHHHHOHHOOOOOHOOOOOHOHOH
HHOHHHOOOOOHHHHOOHHOHOOHHOOHOOHHOHHOHHHHOOHHOHOHHOHHOHOHHOOHOHOOOHHOOHOHHOOOHOHHOOOHHOHHHHOHHHHHOOOH
HHHHOHHHOHHHOHOOHHHOHOHHOOHHOHHOOOHOOHOHHOOOOOOHHOHOOOOOHHOHOOOHHHHHOOOHHHHHHOOHOHHHOOOOHHOOOHOHHHOH
HOOOOHOHOHOHOHHOHOOOHOHOOHHHOOOOHHHOHHOHHOHHOHHHHOHOHOHHHHOHOHOOHOHHHHOOOHHHHHOHOOOOOHHHHOOHHHOHHOOH
HHHHOOOOOOOOOHHOHHOHHOOOHHOHOHHHHOHOOOOOHHHHOOHHOOOOHHHOHOOHHHHOOOOHHOOHHHOOHHOHOHHHHHOHOOHHHOOOHHOH
HHOHHHHHOHOHOOOOHHOHHHOHHOOOOOHHHOOOHHHOHHOHHOHHHOHHHOOOHOHHHHHHHOHHHHOHOHHOOHOOOOOHHOOHOHHOHOHHHHOH
HOOOOOOOOHHHHHHOHHOOHHOHHHHHOHHOHHOHHHHHHHOHOOOHOOHOHHHOOOOHOHOOOOOHHOOHOOHHOHOHHHHHHHOHOOOOHOOHHOOH
HHOHHHHHHHHHOHHOOHHOHOOHOHHOOOOOHHOHHOOHHOOHHHOHOHHOOOHHOHHHOHHHHOHHHHOHOHHHOHOOOHOHOHOHOHHHHOHHOOHH
HHHHHHHHHHOOOOHHOOOOHHOHOOHHOHHHHOOOHOHHOOHHOHOHOOHHHOHOOOOHOHHOHOHHOOOOOOOOOOOHHHOOOOOOOOOOOOOHOHHH
HOOOOOOOOHHHHOHHHOHOOOOHOHHOOOHHOOHHHOOHHOHHOHOOOHHOOOOOHHHHOHHOOOHHHHHOHHOHOHOOOOOHHHHHHOHHHHHHOHOH
HHHHHHHHOHOOOOHOHHHHOHHHOOHHHOOOOHHOHOHHOOHHOOOHHHHHHOHHHOOHOOHHHOOHHOHOHHHHHHHHHHHHHHOHHHHOHHOHOHOH
HOOOOOOOOOOHHOOOHHOHOHHHHOHOOOHHOHHOOOHHHOOHHHOOHHOOOOOOHHOHOHHHHHOOOOOOOOOOHOOOHOHHOHOOOHHOHHOOOOOH
HHHHOHHHHHHHOOHOOOOOOHOHOOHOHHHHHHOOHHHOHOHHOOOHHHHHHOHHHHOOOOHOHHOHHHHHHOHOOOHHHOOHOHOHHHOOHOOHHHOH
HHHHOHOOOOHHHOHHHHHHOHOHHOHOOOOOOHHOHOHOHOOOOHHHHOOHOOOHOHHOHHHOHOOOOHOHHHHHOHHHHHOOOOOHOHOHHOHHHHHH
HOOHHHHOHOOOOOHOOOOOOOOHOOOOHOHHHHOOOOOOOOHHHHOOHHOHHOHHOHHOHOHOHOHHHHOOOHOHHHHOOHHOHOHHOHOOOOOOOOOH
HOHHHOHHHHOHHHHHHHOHHHOHHHOHHOOOHHHHHHOHHHHOHHOHHOOHHOOOOHHOHOOOOOOOOHOHOHOOHOHHOHHOHHHOOHHOHHHHHHHH
HOHHOOHHHOOHOOOOOOOHOOOOHOOOHHHHHOOHHOOOOHHOHHOOHHOOOOHHHHOOHOHHHHOHHHOHHHOHHOHHOOOOOHHOHHOOOHHOHOHH
HOOHOHHOOOHHOHHHHHHHHHHOOOHOOHOOHHOHOOHHHHHOOHHOOHHHOHHOOHHOHOOOHHHHOOOOHHOOHOHHOHHHHHHOHOOHOOOOOOOH
HHOOOHHHHHHHHHHOHOHOHHHHHOHHHHOHHOOHHOOHOOHHOHHOHHOOOOOOHHHOHOHHHOHHHOHHHOOHHOHHOHHOHHOOOOHHHHOHHHHH
HOOHHHOOOHHOOOHOHOOOHOHOOOOHHOOOHHOHHHOOOHHOOHHOHHHHHHOHHOHOOOOHHOHOHOHHHHOHOOHHOHHOHOOHHHHOHHHHHHHH
HHOOHHHHOOHHHOOOOOHOOOHHHHOOHOHHHOOHOOOHHHHHOOHOOOHHHHOHOOOOHHHHOOOOOOOOHOOHOHHOOOOOOOHHOOOOOOHOOOOH
HHOHHOOHHOOHHHHHHOHHHOHOOHHOOOOOHHOHHOHHOHOHOHHOHHHOOOOHOHHHHHHHHHOHHOHHHOHHOOHHOHOHOHHHOHHOHHHOHHOH
HOOOHHOHOOHHOHHHHHHOOOHOHHOOHHHHHOOOHOHHOOOOOHHOHOHHHHOHOOOHHOOHHOOOHHHOOOOHHOOOOHHHOHHOOHHHHOHOHHHH
HHHOHHOOOHHOOOOOHHHHHOOOHHHOOOHOHHOHHOOHOHHHHHHOHOHHHOOHOHHHHHOOHHOHHHOOHOHHOOHHHHHHHHHHOHOHHOOOOOOH
HOOOOHHHOOHHHOHHHOHOHHHOHOHOHHHOHOOOOOHHOOHHHOHOOOHOHHOHOHOHHOOHHHOHOHOHHHHHHOOOOHOOHOHOOOOOOOHHHHHH
HHHOHHOHOHHOOOHOHOOOOOOOOOOOOHOOHHHOHHHHOHHOHOHOHHHOOOOHOHOOHHOOOHOHOHOOHHHOHOHHHHOHHOOOHHHOHOOOOOOH
HHOOHHOOOHHHHOHOHHHHHHHHHHHHOHOHHOHOHHHOOHOOOOOOOOHHHHOHOOOHHHHOHHOOOOOHHOHOHOOOOHOOHOHHHHHHHHHHHHHH
HOOHHHHHOOHHOOOOOHOOOOHOOOOOOOOOHOHOOOHHOHOHHHHHHOHOOHOHOHHHOOHOHHOHHHHHOOHOHOHHHHOHHOHOOOOOHHHOHHOH
HHOHOOHHOHHHHHHHOHHHHOHHHHHHHOHHHOOOHHHOOOOHOOHOHHHHOHOHOHOHHOHOHHOOOOOHHOHOOOOOHHOOOOOOHHHHHOOOOOOH
HHOHOHHOOOHHOHOHOHOHOOHOHOOOHOOOHHOHHHOOHOHHOHHOOHHOOHOHOOOHHOHOOOOHOHOHHOOOHOHHHHHOHHHHHHHOHOHHHHHH
HOOHOHHOHHHOOHOOOOOHHOOOHHHOHOHHHOOOOHHOHHHHOOHHOOHHOOOOOHHHOOOOHHOHHHHHOOHHHOHHHHOOOOOOHOOOOOOOOOOH
HHOHOOOOHOHHOHHHHHOOHOHOOOOOOOOOHHOHHHOOOHOHHOOHOHHOOHHHHHOHHOHHHHHHHOHHHOHOHHHOHOOHHHHHHOHHHHHHOHOH
HHOHHHHOHOHHOHOOOOOHHHHHHHHHHOHHHOOOOHHOHHOHHHOHOOHHOOOOHHOHHOHHOOHOHOOHHOOOOHHOHHOOOOHHHOOOOOOHHHOH
HOOHOHOOOOHHOHHHOHOOHHOHOHHHHOHOHHOHHHHOHHOOHHOHOHHOOHHHHOOOHOOHHOHOHHOHOOHHOOHOHHOHHHHOOOHHOHOHHHHH
HHOOOOOHHHHHOHOHHHHOHOOOOOOOOOHOHHOHHOHOHHHOOOOOOOHHOOHOHHHOHOHHOOOOOHOOOHHHHOOOOOOOOHHOHHHHHHHHOHHH
HHHHHOHHOHHOOOOOHOHOOOHOHHHOHOOOOOOOOOOOOOOOHHOHHHHHOHHOOHOOOOHHHOHHHHOHHHOHHHOHOHOHOHHOHHHOHOHHOOOH
HOHOOOOHOOHHOHHHHOHHHHHOHHOOHHOHHOHHOHHOHHHHHHHHHOHOOOHOHHOHHHHOHOOHHHOOOOOOOHOHHHOHOOOOOOHOHOOOOHOH
HOHHHHOOOHHHOHOHHOHHHOOOHOOHHOOHOOOHOHOOHOHHOOHHOOOOHOHOHHOHOHHOHOHHOOOHHHHHHHOOHHHHHOHHHOOOOOHHHHOH
HOOOOOOHHHOHOHOHHOOOOOHHHHOHHHHHHOHHOHHOHOHOOHHHHOHOHHHOHHOHOOHOHOOOOHOOOHOOOHHOOOOOHOHHHOHOHOHHHHHH
HHHHHHOHHHOOOOOOHOHOHOHHOHOHOOOOOOOHOHOOHOHOHHOOHHHOOHOOHHOHOHHOHOHHHHOHHHOHHHHHHHHHHHHOHHHHHHHOOHHH
HOOOOOOHOHHOHHHHHHHHHHHOOOOHHOHOHOHHHHHOHOOOOOOHHHHHOOOHHHOHOHHOHOOOOHOOOOOOOHOHHOHHHHHOOHOHHHHOHHOH
HOHOHHOHOHHOOHHOHHOHOHOOHHOHOOHOHHHOHOHOHOHHHHHHOOHOOHHHOHOHOOOOOOHHHHHHHOHHOOOOOOOOHOHOHHOOHOOOHOOH
HOHOHOOOOOHHOOOOHHOOOOOHHHOHOHHOHOOOOOOOOOOOOHOHHOHHOOOHOHOOOHHHHHHHOOHOHHHHHHHHHHHOOOOOHHOHHOHHHOHH
HHHHHHHOHOHHOHHHHHOHOHHHOHHHHHHOHHHOHOHHOHHOHHOOHOHHOHHHOHOHHHHHOHOHHOOOOOOOHHOOOHHHOHHOOHOHOOOOOOOH
HHOHOOHOHOOHOHOHOHHHHHHHOHHOHHOOHHHHHHHOOOHOHHOHHOOOOHHOOOOOOOOOOOOOOOHOHHHHHHOHHHOHHHHHOOOOOHOHHOHH
HOOOOHHHHHOHOOOHOOHHOOOOOHHOHHHHHOOHOHHHOHHOHOOOHHHOHHOOHHOHHHHHHHOHOHHOOHOHHOOOOOOHHOOHHOHHHHHHHOOH
HHHOHHHHOHOOOHHHOHHHHHHOHHHOOOOOHHOOOOOOOHHHHHOHHOOOOOOHHHOOOOOOHHOHHHHHOOOOOOHOHHOOOOHHOOOOOOOOHHOH
HOHOHOHOOOOHOOOOOOOHHOHOHHOOHHHHHHHHHHHHOOHHOHOHOOHOHHOHHOOHOHOHHOOOOOHHHHOHHHHHHHHHOHHHHHHHOHHHHHHH
HOOOOOOOHOHHHHHOHHHHOOHOOHHOHOHOHOHOOOOHOHHHOHOOOHHOHHOOHHOHHHHHHHHHHHHOHHHHOHOHOOOHOOOOOOOHOOHHHOOH
HOHHHHOHHHHOHHHHHHHOOHHOHHOOOGHOHOHHHHOOOOOOOOOHHHHHHHHOOHOOOOOOHHHOHOHOOOHHOHOOOHHHHHHHHHHHOHHOOOHH
HOHHOOOOHHHOOOOHHOHHOHOOOHHHHOHOHOHHHOOHOHOHOHOOOOOOHHOOHHOHOHHHHOHOOOOOHHHHOHOHHHHOOOOOOOOHHHHOHHHH
HHHHHHOHHOHOHHOHHOHHOHOHHHOHHOHOHOHOHHOHOHOHOHOHOHOHHHHOHHOHOOHOHOHOHHHHHHOHOOOOOOOOHOHOHHOOHOHOOHOH
HHOHOHOHHOOOHHHHHOOOOOOHOHOHOOHOOOOOOOOHOHOHHHOHHHOOHHOOOHOHHOOOOOOOOOOOOOOOOHHHHHHHHHHHHHHHHOOOHHOH
HOOOOOOOHHHOHOHOHHHHHOHHOHOHHOHOHHHOHOHHHHOHOOOOOHHOHOOHHHHHOOHOHHHOHHOHOHOHOOOHHHOHOHOHOHHHHOHHHHOH
HHHHHOHOHOOOHOHOHHOOOOHOOHOHHOOOOHHHHHHOHHHHHHOHHHOOHHOOOHHOOHHOHHHHHHHHHHHHOHOOOOOOOOOHOOOOOOOOOOOH
HHOHHOHHHHHOOOOOOHHHHOHHOHOHHOHHHHOHOHHOOHHOOOOOOHHOOHHOHHHHOHHOOOOOOOOOOOHHOHHHOHOHOHOHOHHOHOHOHHOH
HOOOOOOHHOOOHOHOHHHOOOHHOHOHOOOOOOOOOOOOHHHHOHOHHHHOHHOOOHHOOOHHOHOHHOHOHOHOOOOHHHHHHHOOOOHOHHHHHOOH
HHOHOHOOHHOHHHHHHOHHHOOHOHOHOHHHHOHHHOHOOHHOOHOOOOHHHOOHOOHHOHHHHHHHHHHOHHHHOHOOOOHOOHHOHHHOOOOOHHHH
HOOHOHHOOOOOOOHHHOOOOOHHOOOOOOOOHHHHHHHHOOHHOHOHHOOOHHOHHOHHOOOOOOOOHHHOOHHOOHOHHOHOHHHHHOHHHHHHHOOH
HOHHHHHOHHHHOHHOHOHHHOOOOHHHHHHHHHOOOHHOOHHHHHOOHHHHHOOOHOHHOHHHOHHHHOHOHHHHOHOOHOOOOHOOOOOOOOOHHOHH
HOOOOOHOHOOOOOOOOOOOHHOHOSOOOOOOOOOHOOHHHHHHHHOHHHHHHHHOHHHOOHHOOOOOOOHHHOOOOHOHHHOHHHOHHHOHHHHHOOOH
HOHHHOHOHHOHHOHOHOHHHHHHOHHHOHOHOHHHHOOOOOHHOHOOOOOOOOHOOOHHOOHHOHHOHOOHHOHHOHOOHHOOOOOOHHHHHOOOOHHH
HOOOHHHOHHOHOOHOHOOOHHOOOOOHHHOHOOOOHHHHHHHOOHOHOHHHHOHOHOHOOHHOOOHOHOHHHHHOOHOHHHHHHHOHHOHOHHOHHHHH
HOHHHOOOOHHHHHHOHOHOHHOHOHHHHHHHHHHHHHHOHHHOHHHHHHOHHHHHHHHHOOHHOHHOHOOOOHHOHHOOOOOOHHOOOOOOOHOOOHOH
HOOOHHOHHHHOOOOOHOHOOHHHOOOOOOOOOOOOHOHOHOHOHOHOHOOOHHOHOHOHOHHOOHHHHHOHHHHOOHHOHOHOHHOHHOHHHHOHHHOH
HOHOHHOHOOOOHOHOHOHOHHHOOHOHOHOHOHHHHOHOOOOOOOOOOOHOOHOHOHOHHHHHOOHHHOOOOOHOHHOOHHHHHOOOHOHHOHOOOHOH
HOHOHHOHHOHOHHHOHOHOHOOOHHOHHHHHHHHOHOHOHHHHHOHHHHHHOOOOOOOHHOHHHOOOHHHOHHHHHHHOOHHOOOHOHOOOOOOHOOOH
HOHHHOOHHOHOHOOOHOHHHHHOHHOOOOOOOOOOOOOOOOHHHOOOOOOHHOHHHHHHOOHOHHOHHOOOOOHHHHHHOOHOHOHOHOHOHHHHHOHH
HOHHHHOOHHHOHHOHHHHOOOOOOHHOHHOHOHOHOHHHHHHOHHHOHHHHHHHHHOHHOHHOHHHHHHHOHOOOHHOOOHHHHOHOHOHOOOOHHOOH
HOOOOHHOHOOOHHHHOHHHHOHOHHOOHHOHOHHHOOOOHOOOOHHHHOHHOHHOHOHOOOOOOOOOHHOOHHOHHHOHOOOHHOHOHOHHHOHHOOHH
HHOHHHHOHHOHHOOOOOOOOOHOHHHOHHOHOOHHHHHOHOHHOOOHOOOHOOOOOOOOHOHHOHHHHOOHHOOOOHHHOHHHHOHOHHHOOOOHHOOH
HOOOOOHOHHOOHHOHOHOHHOHOOOHOHOOHHOOHHHHHHOOHHOHHOHOOOHOHHOHOHHHHOOOOHHOOHHOHOOHHOOOOHHHOHHOOHOHHHHOH
HOHOHOHHHHHHHOOHHHOHHOHOHHHOHHOOHHOOOOOOOOHHHHHOOHOHHHHHHHHHHHOHHHHHHHHHHOOHOHHHHOHOOOHOOHHOHOHHOHOH
HOHOHOOOOHHHHHHHHOOHHOHOHOOOHHOHHOOHHOHHOHHHOHOOHHHHHOHOOOOHOOOOOOOOOOOOHHOHOOOHHOHHOHHHHHOOHOHHOOOH
HOHOHHOHOHOOHHHOOOHHOOHHHHHOHHOOHHOOHOHHOOOOOOOHHHHOHOHOHHOOOHOHOHOHHOHOOHOHHHOOHOOHOOOOOHOHHOOHHHOH
HOHOHOOHOHHOOOOOHOHHHHHHHOOOHHOHHHHOHHHOOHHHOHOOOHOOOOOOOHOHOHOHHHHHHHHOHHHHHHOHHOHHOHHHHHOHHOHHOOOH
HOHOHHOHOOHHOHOHHOHOOOOOOOHOHHOOOOHOOOHHOOOHOHOHOOOHOHHOHHOHOHOOOOOOOOHOHHOOOOOHHOOHOOOOOHOHHOOHOHOH
HHHHHHHHHHHHHHHHHHHHHHHHHHHHHHHHHHHHHHHHHHHHHHHHHHHHHHHHHHHHHHHHHHHHHHHHHHHHHHHHHHHHHHHHHHHHHHHHHHHH
