HHHHHHHHHH
HOOHHOHHOH
HOHHOOOHOH
HOOHOHOOOH
HOHHHHHOHH
HOOHHOSOOH
HOHHHOHOHH
HOHHOOHOHH
HOOOGHHOOH
HHHHHHHHHH
