HHHHHHHHHHHHHHHHHHHH
HOOOOOHOHOHHOHHOOHOH
HHHOHOOOOOHHOHHHOHOH
HOOOHOHOHHHHOOHHOOOH
HOHHHHHHHHHOOHHHOHHH
HOHHOHOOHOHHOHOOOOHH
HOOOOOOHHOHOOOOHHOOH
HOHHHHHHOOOOHHOOHHOH
HOHOOOOOOHOHHHHOOHOH
HOHOHHHHOHHHHOHHHHHH
HOOOOOOHOOOOOOOOOOOH
HHOHOHHHHOHHOHHHHOHH
HOOHOOOOHOHHOOGOHOOH
HHOHOHOHHHHHHHHHHOHH
HOOHOHOHOHHOOOOOHHHH
HOHHOHOOOOOOHHHHHHHH
HOOHOHHOHHHOOOHOHOHH
HOHHOHHOOOHHHOOOOOOH
HSOHOHOOHOOOHHOHHOHH
HHHHHHHHHHHHHHHHHHHH
