HHHHHHHHHHHHHHHHHHHHHHHHHHHHHHHHHHHHHHHHHHHHHHHHHH
HOHOOOHHOOHOOOOOOOOOOOOOOHOHOHHOOOHHOHOHOOOHOHOHOH
HOHHHGOHHOOOHOHOHHHHHHOHHHOOOOHHHOOHOOOOOHHHOOOOOH
HOHOOOHHHOHHHHHOOOOOOHHHOHOHHOOHHOHHOHHOHHHOOHOHHH
HOHOHOHHOOHOOOHOHHHHHHHOOHHHHHOOHOOOOOHOOOOOHHHHHH
HOHHHOOHOHHOHHHOHOHHOOHOHHOOHOOHHOHHHHHHHHHHHOHHOH
HOHHOOHHOOOOHHHHHOOHOHHOOHHOHHOOOOOHOHOHOHHOHOHOOH
HOHHOHHOOHHHHOHHHOHHOOOOHHOOOOOHOHOOOHOHOOOOOOOOHH
HOOOOOOOHHHOHOHOHOHOOHHOOOOHOHHHHHOHOOOOOHHOHHHOOH
HOHOHOHSOOOOOOOOOOOOHHHHHHHHHHHOHHOHHHOHHHHOOOHHHH
HOHOHHHOHHOHHHOHHOHOHOOOOOOOOOOOOHHHHHOHOOHOHHHHOH
HOHOHHHOOHOOOHOHOOHHHOHOHHOHOHOHHHHHOHHHOHHHHOHOOH
HOHHHOHOHHOHHHHHHOOOHOHHHHHHOHOOOOOHOHHOOOHHHOHOHH
HOOOOOHHHHHHHOHOHOHOOOOHOOOHOHOHHHHHOHHOHHHOHOHOOH
HHOHOHHHOHHOOOOOHOHHOHOOOHHHOHOOHOHOOOOOOOHOHOHOHH
HOOHOOOOOOOOHHOHHOOHOHOHHHHHHHHOOOOOHHOHOHHOOOOOOH
HHOHHOHHOHHOHOOOHOHHHHOOOOOOOOHHHOHOOHHHOOOOHOHOHH
HOOHHOHOOOHHHHOHHOHOHHHHOHHHHHHHHHHHOOOHOHOHHHHOOH
HHOHHOHHOHHHHOOOHOOOOHHOOOOOOOOOOHOHOHHHHHHHHHHOHH
HOOHOOHHOHHOHHHOHHOHHHHOHOHHOHOHOOOHOOHOHOHOHOHHHH
HOHHHOHHOHOOOOOOHHOOOOHOHOOHHHHHOHHHHOOOOOOOOOOOOH
HHHOHOHHHHHOHHHOOHHOHOHOHOHHHOHHOOOHHOHHOHOHOHHHHH
HHOOOOHOOOHOOOHHOOHOHHHOHOOOOOOHHOHHOOOHOHOHOOOHHH
HOOHHHHHHOOOHHHOOHHOOOHOHHOHHOHHOOOHHOHHOHOHOHOOOH
HOHHOOOOOOHOOOHOHHOOHOHHHOOOHHHHOHOOHOOHOHHHOHOHOH
HHHOOHHHOHHHOHHHHHOHHHHHHHHOHHHOOHHOHHHHHHOOOHOHOH
HHHOHHHHOHOOOHHOOOOOOOOOHHHOOOHHOHOOOOOOHHOHOHOHOH
HOOOHOOOOHOHOHHOHHOHOHHOOOHHHOOHHHOHOHHHHOOHHHHHOH
HOHHHHHOHHOHOHOOHOOHOOHHOHHHHOHHHHOHOOOOHHOOOOOHOH
HOHOOHHOOHOHOHHOHHOHHOHHOOOOHOOHOHHHHHOHHHHOHOHHOH
HOHHOOOOHHHHHHHOHHOHHOHHOHHOHHOOOOOOOHOOOHHOHOHHOH
HHHOOHHOOOOHHOHOOHOHOOHHOOHHHHOHHOHOHHOHHHOOHOOHOH
HHOOHHOOHOHHOOOOHHOHOHHHOHHHOHOHHHHOHHOOOHOHHOHHHH
HOOHHHHOHOOHOHHOOHHHHHOOOOOOOHOOOHHHHOOHOHOOHOOHHH
HHOOOHHOHOHHOHOOHHHHHHOHHHOHHHHHOOOHHOHHOHHHHHOOOH
HHHOHHHOHOHHOHHOHHOHOOOHHOOOOHHHHHOOHHHOOOOOOHHHOH
HOOOOOHOHOHOOHHOHOOOOHHHOOHHOOOOOHOHHHHOHOHHHHHHHH
HHHOHOHHHHHOHHOOHHHOHHHHHOHHOHOHHHHHHOHHHOOOOOOOOH
HOOOHOHHOHOOOHHHHOOOOOOHHOHHOHOOHOHOHOHHOOHOHHHHHH
HOHOHOOOOHHOHHHHHHOHOHOHOOOHHHHOOOOOOOOHHOHOHHHOOH
HOHOHOHHOOHOHOOOOOOHOHHHOHOOOHHOHHOHHHOHOOHOOOOOHH
HHHHHOOHOHHOHOHOHOHHHHHOOHHOHHHOHHOOOHOHOHHHOHHOOH
HHOOOOHHOHHHHHHHHOOOHOHOHHOOHHOOOHOHOHHHOOOHHHHHOH
HOOHOHHOOOOOHHOHHOHOOOHOOHHOOHOHHHHHOHHOOHOOHOHOOH
HHOHOOHHOHHHHOOOOOHOHOHOHHHHOHOOOOHHOOHOHHHOOOHHOH
HOOHOHHHOHOOOOHHHOHHHHHHHHOOOHHOHOHHOHHOOHHOHOHOOH
HOHHOHOHHHHOHHHHOOOOOOOHHOOHOHHHHOOHOOHHOHHOHOHOHH
HOHHOOOOOOHHHHOHHOHOHHOHHOHHOOOOHHOHOHHHHHHHHOHOOH
HOOHOHOHOHHOOOOOOOHOOHOHHOHHOHOHHOOHOOOOOOOOHOHOHH
HHHHHHHHHHHHHHHHHHHHHHHHHHHHHHHHHHHHHHHHHHHHHHHHHH
