HHHHHHHHHH
HOHOOOOOOH
HGHOHHHOHH
HOHOOOHHHH
HOOOHOOOOH
HOHHHHOHHH
HOHHHOOOHH
HOHHHOHOOH
HOSHHOHOHH
HHHHHHHHHH
