HHHHHHHHHH
HOHHOHOHOH
HOHOOHOHOH
HOHHOOOOOH
HOHHOHOHHH
HOOHHHOHOH
HHOOHSOOOH
HHHOGOHHOH
HOOOHOOHOH
HHHHHHHHHH
