HHHHHHHHHHHHHHHHHHHH
HOOOHHOHOHOOHOHHOOOH
HHOHHHOOOHHOOOOHHOHH
HOOHOHHHOOHHOHHHHOOH
HHOHOHHOOHHHOOHOHOHH
HHOHOHOOHHOHOHHOHOHH
HOOHOHHOHOOOOOOOOOOH
HHOOOHOOHHOHOHOHHOHH
HOOHOHHOOHOHHHHHHHHH
HHOHOHHHOOOOHOHOHHOH
HOOHOOOOOHHOOOOOOOOH
HHHHHOHOHHHOHHHOHOHH
HOHHOOHOOOHOOOHHHHHH
HOOOOHHHOHHOHHHHOHOH
HHHOHHOOOHOOOOOOOOOH
HOOSOHHHHHHOHOHHHHHH
HHOHOOOHHOOOHOOOOOOH
HOGHOHOHHOHOHHOHOHHH
HHOHOHOHHOHOOHOHOOOH
HHHHHHHHHHHHHHHHHHHH
