HHHHHHHHHHHHHHHHHHHHHHHHHHHHHHHHHHHHHHHHHHHHHHHHHH
HOOHOHHOHHOOHHOOHHOHHOOHHOHHOOOOOOOOHHOHHOHOHHOOOH
HHOOOOOOOHHOHOOHHOOHHHOOOOOHHHHHOHHHHOOOOOOOOOOHHH
HHHHHHOHHHHOHHOOHOHHOHHOHHHHOHOOOOHOHHHOHOHHHHHHHH
HOHOOOOOHHOOHOOHHOOHOHOOOOOHOHHOHHHOHOHOHHHHOOOOOH
HOHHHHHOOHHOHOHHHHOOOHHOHHHHOOHOHOHOHOHOHHOOOHHHHH
HOOOOHHHOHHOHOHHOOOHHHHOHOHHHOHOHOHOOOOOOOOHOOOOOH
HHHOHHOOOHOOOOOHHHOHOHOOOOOOHOHOHOOOHHOHHOHHOHHHHH
HOHOOHHHOHOHOHOOHHOHOHOHHHHOHOHOHOHHHHHHHHHOOOHHHH
HOHOHHOOOHHHOHHHHHOHOHOHHOHHHOHOHOHHOHHOOOHHHHHOOH
HOOOOHHHOHHOOHHHHOOHOOOOHOOHHOOOHOOOOOHOHHHOHOHHOH
HHOHHHHOOOHHOOOOHHOHOHHHHOHHHHOHHOHHHHHOHHOOOOOHOH
HHOHOHOOHHHOOHHOHOOOOOOHHOOOHHOHHOHOHOHOHHOHOHHHOH
HOOHOHHOOOHHOHHHHHHHOHHHHOHHHOOOOOOOOOOOHHOHHHOOOH
HHOHOHHHHOHHOOOHOHOHOHHOOOHOHHHOHOHHHOHOOOOOHOOHOH
HOOOOOHOHOHOOHHHOHOOOHHOHHHOHHOOHOOOHHHHHHHOOOHHHH
HHHHHOOOOOHHOHHOOOOHHHOOOOHOHHOHHOHHHHOHOHHOHOOOOH
HOOOHHOHHOHHOHHHHHOHHHHHOHHOOOOOHHHOOOOHOOHHHHHHHH
HOHHHHHHOOOOOHOHOHOOOHOHOOOOHOHOOOHHOHHHOHHHOHHHOH
HOHOHOHOOHHHOHOOOHHOHHOHOHHHHHHHHHHOOOOOOOOOOOOOOH
HOOOHOHHHHOOOOOHOHHOOHOHOOHHOHOHHHOOHHOHOHHHHHHHHH
HOHOOOHOOHHHOHHHHHHHOHOHOHHOOOOHOOOHHHOHHHOOHHOHOH
HHHHHOOOHHOHOHHOHHOHOOOOOOOOHHHHOHHHHOOOOHHOOOOOOH
HHHOHHOHHOOHOHHOHHOHOHHHHHOHHHOOOOOOHOHHHHHOHHHHHH
HOHOHHOOHHOOOOOOHHOOOHOOHHHHOHHOHHHHHHHHOHOOOOOOOH
HOHOHOOHHHHHHOHHHHOHOOOHHOHHOHHOHHHOHHOHOHOHOHOHHH
HOHOHOHHOOOHOOHOHOOHHHHHHOOOOOOOOOOOOOOOOOOHHHOOOH
HOOOHOHHHHOHHOHOHHOOHOHOHOHHHHHHHHOHOHHHHHOHHHHHHH
HHHOOOOHHOOOOSHOOHHOOOOOOOOOOOHHHHHHOOOOOHOOOOOOOH
HHHHOHHHHHHOHOOOHHOOHHHHHHHHHHHOOOHHHHHHHHHHHHHHHH
HOHOOOOHOHOOHOHOHHHOOOOHHHOOOOOOHOOHHHOOOOOOHHHOHH
HOHHOHHHOHHOHHHOOOOOHOHHOHOHHHHHHHOOOOOHOHHOHOOOOH
HOHOOOOHOHHHHOOOHHOHHHHOOOOOHHOHOHHHOHHHHHHHHOHHOH
HOHHOHHHOHOHHHOHHHOHOHOOHOHHHHOOOOHHOOOHHOHHHOHHHH
HOOOOOOOOHOOOHHHHOOOOOOHHHHHOOOHHOOHHHHHHOOOOOOOOH
HOHOHHOHOHOHHHHHOOHHHHHHOHHOOHOOHHOOOOOOHOHHHHHHHH
HOHOHHOHOOOOOHOHHOOOOOOOOOOOHHOHHOOHHHHOOOOOOOOOOH
HOHOHHOHOHOHOOOOOOHHHOHOHOHHHHHHHHOOOOHOHOHOHOHOHH
HOHHHHHHOHOHHOHOHOOOHOHOHOOOOOHHOHHHHHHHHHHHHHHHHH
HHHOOOOOOHHHOOHOHHOHHOHOHHHOHHHOOOOOOOOHOOOHOHOHHH
HHHHHHOHOOOHOHHOOHHHHHHOOOHOHOHOHHOHHHOOOHOOOOOOHH
HOHOHHHHOHHHOOHHOOOOOHHOHHHOOOOOOHOOHHOHHHHOHOHOOH
HOOOHOHOOOHHHOHOOHOHHHOOHHHOHOHOHHHOOHOOOOHOHHHOHH
HHHOOOOOHOHOHHHHOHOHOHHOOOHOHHHHHOHHHHHHHHHHHHHHHH
HOOOHHOHHOOOHHOOOHOOOOHHOHHOHHOOOOOOOOOOOHOHHOHHOH
HHHOHOOHHOHOHHOHHHHOHOOHOOHHHOOHOHHHHOHHOOOOOOOOOH
HOOOHHOHHOHHHHHHOOOOHOHHHOGHOOHHOOOHHHHHHHHHHOHHOH
HHOHHHHHOOOOOOOHHOHOHHHOHHOOOHHOOHOOOHOOOOOHHHHHOH
HOOHHOOOOHHOHOHHOOHOOOOOHHOHOOHOHHOHOOOHOHOOOOOHOH
HHHHHHHHHHHHHHHHHHHHHHHHHHHHHHHHHHHHHHHHHHHHHHHHHH
