HHHHHHHHHHHHHHHHHHHH
HOHOOHOOOHOOHHOOOHOH
HOHHOOOHOHOHHHHHOHOH
HOOOOHOHOOOHOHHOOOOH
HHOHOHOHHHOHOHHHHHOH
HOOHOHHHHHOHOOHHOOOH
HHHHOHHHOOOOOHHHHHOH
HHHHHHOHHHHHOHHOHOOH
HOOOHOOHOOOOOOHOHHOH
HHHOHHOOOHHOHOOOHOOH
SOOOOOOHOHHHHHHOHOHH
HOHHHOHHOHOOOOOOHOOG
HOHHOOHHOHHHHHHOOOHH
HOOHOHHHHHOOOOOOHOOH
HHOHHHOOOOOHOHHOHOHH
HOOHHHOHHHOHOHHOHOOH
HHOOOHHHHHOHHHOOHOHH
HHHOHHOOOOOOOHHOHOOH
HOOOOHOHOHOHOOHOHOHH
HHHHHHHHHHHHHHHHHHHH
