HHHHHHHHHHHHHHHHHHHHHHHHHHHHHHHHHHHHHHHHHHHHHHHHHHHHHHHHHHHHHHHHHHHHHHHHHHHHHHHHHHHHHHHHHHHHHHHHHHHH
HHOHHHHOHOHHOHOHOOOOHOHOOHOHHOHOOHHOHHOHHOOHOHOHOOOHOOHOHOHOOHOHOOOOOOOOHOOOOHHOHHOHOOOOOOOOHOHHOHOH
HOOOHHOOHOOOOHOHOHHHHOHHOOOOHOHOHHOOHHOHHOHHOOOOOHHHOHHOHOHHOOOOOHHHOHHHHOHHHHOOOHOOOHHOHHHHHOHHOHOH
HOHOOHHOOOHHOOOOOOOHHOOHHHOHHOHOOHHOHHOHHOOHHHHHOOOHOHHOOOOHOHHHOHHHOOOOOOHOOHHOHHOHHHOOOOHHOOHHOHOH
HHHHOOHOHOOHHOHHHOHHOOHHOHOHHOHOHHOOHHOHHHOOHHOOOHHHOOHHOHHHOOHHHHOHHHHHHHHOHHOOHHOOOHHHHHHHHOOHOHOH
HHHHHOHOHHOOHHHHHHHHHOHHOHOHOOHOHHOHHOOOOHOHHHHHOHHOOHHOOOHHOHHOHHOOHOOHHHOOOHHOOHOHHHOHHHOHHHOOOOOH
HOHOHOOOOHOHHHOOHHOOHOHOOHOHHOHOOOOOHHHHOHOHHOOHOOHHOHHOHHHOOHOOOHOHHOHHOOOHHHHHOOOOHOOHOHOHOHOHHHHH
HOOOHOHHHHHHHOOHHHOHHOHHOHOHHOHOHHOHHOOHOHOOHHOHOHHHOOHOHHHHOOOHHHOHOOOHHOHHHOHHOHHHHOHHOOOOOOOOOOHH
HHHOHOOOOOHOHHOOHOOOOOHHOOOOOOOOOHOOHHOOOHHOOOOHOHOHOHHOOOHOOHOHHHOHOHHHHOOHOOHOOOHHHOOHHOHHHOHHHOOH
HOHOOOHHHOOOOHHOOOHHHHHHHOHHOHHHHHOHHHHHOHHOHHHHOOOOOOOOHOOOHHHHOHOHOHOOHOHHOHHOHHHOHOHHOOOOHOOHHHOH
HOHOHHHHHHHOHHHHOHHHOOHOHHHOOHOHHHHHOHOOOHHOHOOHHHHOHHHHHHHOOOHHOHOOOOOHHOHHOOOOOOOOOOOOOHOHHHHHOOOH
HOOOOOOOOHHHHOHHOOOHOHHOOHOOHHOHOHHOOHHHOHHOOOHHOHOOHOHHOHHHHOOHOHOHHHHHHOHHOHHHHHOHOHOHOHOOOHOHHOHH
HHHOHHHHHHOHHOHOOHHHOHHHOHHOHHOHOOHHOOHHOHHHHOOHOHHOHOOOOOOHHHHHOHOOHOOOOOHHOOOOHHHHHHHHOHOHOOOHHOOH
HOHOOHOOHHOHOOHHOOOOOOHHOHOOOOOOOHHHOHHOOOOHHOHHOHHOHOHHHHHHOHOHOHOHHOHHHHHHOHHHHOOOOOHHOHHHHHHHHHHH
HOHHOHOHHOOHOHHOOHHHHHHOOHHHHHOHHHOHOOHHHHOOHOHHOHHOOOOOHHOHOHOHOOOOOOOOHHOOOOOOOOHHHOHHHHHOHOHHOHHH
HOHHOOOOHHOHOOHHOHOHHOHHOOOHHOOOHHOHHOHHOHHOHOHHOHOOHOHOOOOOOHOOOHHOHOHHHHHOHHOHHOOOHOHOHOOOHOOHOHOH
HOOOOHHHHOOOOHHOOOOOOOHHOHHHOOHOHHOHOOHOOOOOOOHHOHOHHHHHHHHHHHOHHHHHHHHOOOOOOHHHHHHHHHHOHHHOHOHHOOOH
HOHHHHHOHHOHHHHHOHHHHHHHOHHOOHHOOOOHHOOOHHHHHHHOOOOOOOOOOOHHOHOOHOOHOHHHOHHHHHHOHOOHOHOOHOHOOOOHOHHH
HOHOHHOOOOOOHOHOOOHOHHOHOOHHHHHHHHOOHHHOOOOHHOHHOHHHHHOHOHHOOOOHHOHHOOHHOOOOHOHOHHOOOHHOOOOOHHOOOOOH
HOOOOHHOHHHHHOOOHHHOOHOHOHHOHHOHOHHOHHOOHHOHHOOHOHOHOHHHHHHHHHOHOOOHHOOOOHHHHOOOOOOHHHHHHHHOOHOHOHHH
HOHHOHHOOHHOHHOHHOHHOHOHOHHOOHOHOHOOOOOHHHHHHHOHOOOOOOHOHHHOHOOOOHOOOOHHHHHOHHOHHHOOHHOHOOOOHHOHHHOH
HOHHHHOOHHOOHHOOHOHHOOOHOOHHOHOHOHHHHHOHOOHHOHOHOHHHHHHOOHOOHHOHHHHOHHHOOOHOOOOOOHOHHHOHHHOHHHHHHOOH
HOOOHHOHHOOHHOOHHOHHHOHHOHHOOOOOOOOHHOOOOHHHOHOHOOOOOOHOHHOHHOOOOOHHHHHHHOHOHHHHHHHHOHOHOHOHOHHOHHOH
HOHHHOOOHHOHHOHHOOOHOOHHOOHHHHHHHHOHOOHHHHOHOOOHOHHHHHHOHHOHHHOHHHHHHOHOHOHOOOHHHHOOOHOHOHOOOOHOHOOH
HOOHHOHHHHOHHOHHOHHHOHHHOHHOOOOOHOOHHOHOHHOHHHOHOOHHHOHOHHOOHHOHOHHOHOOOOOOOHOOOOHHHOOOOOOOHHHHOHOHH
HOHHOOOHOHOHOOOHOOOOOHHOOOHHHHHOHHOOOOOOOHOHHOOOOHHOHOHOHOOHHOOOOOOOOOHOHHHHHHOHOHOHOHOHHHHHHOOOHOHH
HOHHHHOOOHOHHOHHOHHHOOHHHOHOHHOOHHHHOHHHHHOOHHHHOOOOOOOOOOHHHHHOHHHOHHHHHHOHOHHHHHOHHHOHOHHOOOHHHOOH
HOOHOHOHHHOHHOHHOHHHHHHHHOHOHHHOOHHOOOHHOHOHHHOHOHHHOHHHOHHHOHHOOHHHHHOHHOOOOOHOHOOOHHOOOOHOHHHHHHOH
HHOOOHOHOHOHOOOOOHOOHHHOOOHOHOOOHHHHOHHOOHOHHOOHOOHHHHOHHHOHOHOOHHOHHOOOHOHHHHHOOOHHHHHHOHHOHOHOHOOH
HOOHHHOHOHOHHOHHHHOHHOHHHOOOHHHOHHHOOOHHOOOOHHOHOHHOHOOOOHOHOHHOOHOHHOHHHOOOHHHOHHHHOOHOOOHOHOHOHOHH
HOHHHHOHOHOHHOHOHOOOHOHOOOHHHOHOOHOOHOOHHOHHHHOHOOOOHOHHHHOOOHHOHHOHOOHHOOHHHOHOOOOHHOHHOHHOHOHOHOOH
HOOHOHOHOHOHOOHOHHOHHOHHOHHOHOHHOOOHHHHHHOHOHOOOOHHHHOOHOHHOHHOOOOOHHOOHHOHOOOHOHOHHOOOOOOHOHOHOHOHH
HOHHOHOHOHOHHOHOHOOOHOOHOHHOHOHOOHHHOHHHOOOOHOHHHHOHHOHHOOHOOOOHHHHHOOHHHOOOHHHOHHHHHHHHOHHOHOHOHOOH
HOOHOHOHOHOHHOHOOOHHHOHHOOHOOOOOHHHHOHOHHHHOOOHHHOOOHOHHOHHOHHHHOOOHHOOOOOHHHOHOOHOHHOOOOHOOOOOOOOHH
HOHHOHOHOOOHHOOOHHHHOOHHHOHHHHHOOHOHOHOHOOHHHOHOOOHOOOOHOOOOHOHOOHHHOOHHHHHHHOOOHHOHHHOHOHHOHOHOHOHH
HOHHOOOOOHHHHHOHHHOHOHHOHOHOHHHOHHOHOHOOOHHOHOHOHHHHHHHHOHHHHOHOHHOHHOOOOOHOHHOHHHOHOHHHOHHOHHHHHOOH
HOHHHHHOHHOOHOOOOOOHOHOOHOHOOOOOOOOOOHHOHHOOOOOOOOOHHHOHOHOOOOHOOOOOOOHHHHHOHOOHHOOHOOHOOOOOOHOHHHOH
HOHOHOOOOHHOOOHOHHOHOHOHHOHHHHHHOHHHOHOOOHHOHOHHOHOOOOOOOOOHHHHOHHHHHHHOOHOOOOHHHHOOOHHOHHOHOOOOOHHH
HOHOHOHHHHHHOHHHHHHHOHOOHOOHHOOHOOOHHHHHOOOOHHHHHHHOHHHHHHHHOHOOOHOHHOHHOOOHHHHOOHHHOOOOOHHHHHHHHHHH
HOOOOOOOHHOHOHHHOOHOOHHOHHOHHHOHHHOOHHOHHHOHHHOOHOHOOOOOOOOHOHOHHHOOOOHOOHHHOHHOHHOHOHHHOOHHOOHHOHOH
HOHHOHHHHOOOOOHOOHHOHHOOHHOOOOOHOHOHHOOOHHOHOHOHHOHHHHHHHOHHOOOHOHOHHHHOHHHOOHOOOOOOOHOHHHHHHOOHOHOH
HHHHOHOOHHHOHHHOHHOOHHHOOHHHOHHHOHOOHHOHHOOOOOOOOOOOOHHHHHHHHHOHOHOOHOOOOOHHOHHOHHHHOOOOOOHOHOHHOHOH
HHOHOOOHHOHOOOOOOOOHHOHHOHOOOHHOOHOHHOOOHHOHHOHHHOHHHHOOOOOHHHOHOHOHHOHHHHHHOHHOOHHHOHHOHOHOHOOOOOOH
HOOOOHHHHOOOHHOHHHHHOOOHOOOHHHHHOOOOHHOHHOOOHOOHHHHOHHOHHHOHOOOOOOOOHOOHHOHOOHHOHHOHHHHHHHHOHOHHHHHH
HHHHOOHOHHHOHHHHOOHHHHOHOHOHHHHOOHHHHOOHHOHHHOHHOHHOOHOOOHHHHHOHHHHHHOHHOOHOHHOOHOOOHHOHHHOOOOOOOOHH
HHOHHOHOHOHOOOHHOHHOOOOOOHHHOHOOHHHOHHOHHOHOHHHOOHOOHHOHHHOOHOOHOOOHHOOHHOOOOHHOHOHHHOOOHOOHOHHOHOOH
HOOHHOHOOOOOHOOHOHHHOHHHOOHOOOOHHOOOHHOOOOOOOHHHOHOHHHOHOHHOHOHHOHHHHOHHHHOHHHHOHOHOHHOHHOHHHHHHHHHH
HHOOHOHOHHHOHHOHOOHHHHOHHOOOHHOOHHOHHHHOHHHHOOHHOHOHOHOHOHHOHOOOOOOOHOHOHHOOOOOOOOOOOOOOOOOOHHOHHHOH
HHHOHOHOOHHHHHHHOHHOHOOHHHHOOHHHHHOOHOHOHOHHHHHOOOOOOOOOOHHOOOHHHHHOOOOOOOOHHHOHOHHOHHOHOHHOHOOOHOOH
HOHOOOHOHHOHOHHOOOHOHHOHOOOOHHOOHOOHHOOOHOHOHHOOHHHHHHHHHHHOHHHHHHHHHHOHOHOOHHHHHHHHHHHHHHHHHHOHHOHH
HOHOHHHOOHOHOOHHHOOOHHOHHOHOOHHOOOHHHOHHHOHOOHOHHOOOOHHOHHOOOOOOOOOOOHOHHHHHHOOHHOOHOOOOHOOHHOOOOOOH
HOHOHHOOHHOOOHHOHHHOHHOOHOHHOOHHOHHOOOOHHOHOHHOHOOHHHHHOOOOHHHHOHHHHHHOHHOHOOOHHOOHHOHHHHOHHHHOHOHOH
HOOOOHHOHHOHHHHOHHOOHHOHHHHHHOOHOHHHHHOHHOHOOHOOOHHOHHOOHHOOHHHHHHOHHHOHHOHOHHHHOHHOOOOOHOHHOOOHHHHH
HHHOHHOOOHOHHOHOHHOHHHOHOHOOHHOHOOOHOHOHHOHOHHOHHHHOOHHOOHHOOOOHOHOOOHHHHOOOOOOOOOOOHHHOHOHHHHOOHOHH
HOOOOHOHHHOOHOHOHHOHHOOOOOOHHOOOOHHHOHOHOOOOOOOOHOHOHHHOHHHHOHHHOOOHOHHOHOHHHHOHHHHHHOHHHOOHHHHOOOOH
HHHHOOOHHOOHHOOOOHOOHHHOHHHHHHOHHHHOOHOHHOHHHHHHHOOOHOHOHHOHHHHOOHHHOHHOHOOOHHHHOHHOHOOHOOHHOHOOHHHH
HOHHOHOOHHOOHOHHHHOHHOHOOOHOHOOOOOHHOHOOHOOOOOOHHOHHHOHOOOOOHOHHOHHHHHHOOOHHHOHHOOOOOOHHOHHHOHOHHHHH
HOHHHHHOOHHOHOHOHHOHHOHOHHHOHHOHHHHOOHHOOOHHHHHHOOHOHOHOHHHHHOHHOHOHHOHHHOOHOOHHOHHHHHHHOHOOOOOHOOOH
HOOHHOHHOHHOOOHOHOOHHOOOHOHOHHOOOHHHOHOOHOOOOOOHHOOOHOOOOOOHHOHHOHOOHOHOOOHHOHHOOOOHHOOHOHOHHHOOOHOH
HOHHHOHHOOHOHHHOHOHHHHHOHOHOHHOHHHOHOHHOHOHOHOHHOOHOOOHOHHHHOOHHOHOHHOHHOHHHOHHOHHHHHOHHOHOOOHHHOHOH
HOHOHOOHHOOOHHOOOOHHOHHOOOHOHHOHOHOOOHOOHHHHHHHOOHHHOHHHHOOHHOHHOOOOHOHHOHOOOOOOOOOOOOOOOOOHOOHHHHHH
HOHOHHOOHOHOHHHOHHHOOOHOHOHOOHOOOHHHOHHOOHOHOHHOHHOHHHOHOOHHHOOOOHHOOOHOOOOHOHOHOHHHHHHHHHHHHOOOHOHH
HOOOHOOHHOHHHOHOOOHHOHHHHOHOHHOHHHOOOOHHOOOOOOOOOOOHHHOHHOOOHOHHOHHHHOOOHOHHOHHHOOOOOOOOHOOHHHHHHOOH
HOHOHHOOHOOHHOOOHHHOOHOHOOOOOOOHOHHOHOOHOHHHHHHHHHHHOHOHHOHHHOHHHHOHHHOHHOOHHHHHHOHOHHHOHOHHOHOOOOHH
HHHOOHHOHOHHHHHOOOOOHHOHHOHHHHHHOHHHHHOOOOHHOOOOHOHHOOOOOOOOOOOOHOOOOHHHHHOHHOOHHOHOOHHOOOOOOOOHOHHH
HOOOHHOOOOHOHOHHOHHHHOOHOOHHHOHHOOHHOOOHHOOHOHHHHOHHOHOHOHOHOHHOHOHHOOOHHOOHHOHHHHHHHHHOHHOHHOHHHHHH
HHHOHOOHHHHOOOOOOOOOHHOHHOOOHOHHHOHHOHHHHHHHOHOHHOOOOHOHHHHHOOHOOOOHHHOOHHHHOOOOOOOOOOHHHOOOHHHOHOHH
HOOOOOHHOOHHOHHOHHHHHHOHHOHHHOHOHOHHOHHOOOOOOOOOOOHOHHHHHOHHOHHHOHOOOHHHHOOHHHOHHHOHOHHHHHHHHHOOOOOH
HHOHHOOOOHHOOHHHHHHHOHOHOOHHOOOOOOOOOOOOHHHHHHHHHHHHHOHHOOOHOHOHHHHHOHHOOOHHOOOOHHHHHHHOHOHHOHOHOHOH
HHHHHHHOHHHOHHOHHOOHOHOOOHHHHOHHHHHHHOHOOOOOHHHHHHOOOOHOOHHHHHOHHOHHHHHOHHHHHOHHHOHOHOHOHOOOOOOHHHHH
HOHOHHOOOOHOHOOOHHOHOHOHHHOHHOOOOOOHHHHHHOHHHOOOOHHHOHHOHHHOHHOOHOOOHHOOHHOOOOOHOOOOOOOOHOHHHHHHHOHH
HOHOHOOHHHHOOOHHHOOOOOOOOHOHOOHHHHHHOHOHHHHOHOHHOOOHOHOOOOHOOOOHHOHHHHHOHHHHHOHHOHHHHHOHHOHOHOHOHOOH
HOHOHHOHHOOOHOOOHOHOHHHHHHOOOHHHOOOOOOOOHHOOOOOHHHOOOOOHHHHOHHHHHOOOHOHOOHHOHOHOOOOOHHHHHOOOOOHOOOHH
HOOOHOOOHHOHHHHHHHHOHHOHHHHHOHOHOHHOHHHHHHOHHHOOHHHOHOHHHOOOOHHHOOHHHOHOHHHOHOOOHHHHHOHOHOHHHHHOHHHH
HHHOHHOHHHOHOHHOHHOOHHOOOHHOOOOHOHHHHOOHOHOHOHHOHOHHHOHOOOHHHHOHHOOOOOOOOHOOOOHOOOOOOOOOOOOHOHHOOOHH
HOHOHHOOHOOOOHHOOOOHHOOHHHOOHHOHOOHHHHOOOOOOOOHHHOHHHHHHHOOOOOOHHOHHHOHHHHOHHHHHOHHOHOHHOHOOOOOOHOOH
HOHOOHHOHHOHHHHOHHHHHHOHOHHOHHHHHOOOHHOHHOHOHOOHOOOOHHOHHOHHHHHHOOOOHOHHOHOOOOHHHHHHHHHHHHHHOHOHHHOH
HOOOHHOOOOOOHOOOOOHHOOOOOOOOOOHOHHOHHOOOHHHHHHOOOHHHHHOHOOHHOHOHOHHHHOOOOOOHHHHOHOHHOHHOOOOHHHHHHOOH
HOHOHHHHHOHHHOHHHHHHHHOHHHHHHHHOHOOOOOHOOHOOOHOHHHOHHOOHHOOOOOOHOHOHHOHOHHOOOOHOHOHOOOHOHHHHHOHOHHHH
HOHHHOHHOOOHHOHOOOHHOHOOOHHOHHHOHOHHHHHOHHOHHHHHOHOHOOHHHOHOHHOOOOOOHHHOHHHOHOOOOOOOHOOOOOOOOOOOOOOH
HOOHHOHHHOHHHOHOHHHOOHOHHHOOOOOOOOOOOOHOOOOOOHHOOHOHHOHOHOHHHHHHHOHOOHHHHOHOHOHOHOHHHHHHHHHOHHHHOHHH
HOHHOOOHHOOOOGHOHOHHOOOOHOOHOHHHHHHHHHHHOHOHHHHHOOOOOOOOOOOOOOOOHHHHHHOOOOHHHOHHHOOHOHHOHHHOOOOHOOOH
HOHHOHHHOOHHHHHOHOOHHOHHHOHHHHHHHHHHOOHHHHHHHOHHOHHHHHOHOHHHOHHOHHOHHOOHHOOHHOOOHHOOOOOOHOHHHHHHHHHH
HOHHOOOHHOHHOOHOHOHHHOOOOOOOOHOOOOOOOHHOHOHOHOHOOOOOOHHHOOOHHHOOOOOOOOHHHOHHHOHHHHOHOHOHHOOHOHOOHOOH
HOOHOHOHHOHHOHHOOOOOHOHOHHOHOHOHHHHHHHOOOOOOOOOOHOHHHHOOOHOOHHHOHOHHOHHHOOOOHOOHOHOHOHOOOOHHOHOHHOHH
HOHHHHOHHOHOOOHOHHHHHOHHHHHHHHOOOOOHOHOHHHOHHOHHHOOOOHHHHHHOOHHHHHHHHHOHHHHOHHOOOHOHOHHOHOOHOOOOOOOH
HOOHHOOHOSHOHOHOOHHHOOOHOOHOHHOHHHHHOOOOOHOOHOOOHOHHOOHOHOHHHHOHOHOHHOOOOHHHHHHHHHOHOHHOHHOOOHOHOHHH
HHOOHHOHHOHOHHHHOHOHHOHHOHHOOHOOHHHHHOHOHHOHHOHHHHHHHOOOOOOOOOOOOOOOOOHHHHOHHOHHHHHHOOHHHHHOHHHHOOOH
HOOHHOOOOOOOOHOHOHOHHOOOOOHHOHOHHOOHHOHHHOOOHOOOOOOHHOHOHHHOHHOHOHOHHHHOHOOHOOOOOOOHHOHHOOOOOOHHOHOH
HHOOHHHHHOHHOOOOOOOOOOHHHOOHOOOOOOHHOOOOHHOHHOHHOHHHOOHHHHHHHHHHHHOOHHHOHOHHOHHHHHOHHOHHOHHOHHHHOHOH
HHOHHOOOOOHHOHOHOHHHHOOHHHOOOHHOHOOOOHHHHOOOHHHOOOHHHOOOOOOOOOOOOHHOHOHOHOOOOOOOOHOHHOOHHHOOOOOHOHOH
HOOOOOHHHOHHOHOHOOOOHHOOOHHHHHHHHOHHHHHOHHHHHHHOHOOHHHOHHOHHHHHHHHOOOOOOOOHHOHOHHHHHOOHHHOOHOHOHOHOH
HOHOHOOHHOHHOHOHHOHOOHOHOOOOOOOHHOOOOOOOOOOOHOHHHHOOOHHHHOOOOOOHHHHOHHOHOHHHHHOOOOOHHOHHOOHHHHOHHHOH
HOHOHOHHOOOHHHOHOOHHOHOHOHHHHHOOHHOHOHOHHHHHHOHHOHHHOOOOHHOHOHOOOOHOHOOHOOOOOHHHHHOOHHHHHOHHOOOOHHOH
HOHOHOHHOHOOHHHHHOOHOHHHOHOOHHHHHHHHHHHHOOOOHOOOOOOHOHHOHHOHHHOHOHHOHOHHHOHHOHHHHHHHHOOOOOOHHHOHHOOH
HHHOHHHHOHHOOHHOHOHHOOHHOOOHHOHOHOHOOOOOOHHHHOHHHOHHHHHHHOOOOHOHHHHHHOOHHHHOOOOOOOOOHHOHOHOOOHOOHHOH
HOOOHHOOOHHHOOHOHOOHHOOHOHOOOOOOOOOOHOHHOOOHHOHHHHHHHOHHHHOHHHOOOOOHHOHHOHHHHHHHHHHHHHHHHHHHHHHHHHOH
HOHOOHHHOOOHHOOOHHHHHHOHOHHHHOHHHOHHHHHHHHHHOOOOOHOHOOOOHHOHHOOHHOHHOOOOOOHOHHHHOHOHOHHOHOHHOOOOOHOH
HOHOHHOOOHOHOOHOOOOOOHOHOOOOHOOOHOOOOOOOOOOOOHOHOOOOOHHOOHOHOOHHOOOHHOHOHOOOOOOOOOOOOOOOOOOOOHOHOHOH
HHHHHHHHHHHHHHHHHHHHHHHHHHHHHHHHHHHHHHHHHHHHHHHHHHHHHHHHHHHHHHHHHHHHHHHHHHHHHHHHHHHHHHHHHHHHHHHHHHHH
