HHHHHHHHHHHHHHHHHHHHHHHHHHHHHHHHHHHHHHHHHHHHHHHHHH
HHOHOHOOOOOOOHOHOOOOOOOOOOOOOOOOOOOOHHHOHOOHHOHOHH
HOOOOHHHHHHHOOOOOHHOHOHHOHHOHHHOHOHOOHOOHOHHOOOOOH
HHHHOHHOOHHHOHHOHHOOHHHHHHHHHOHOHHHHOHOHHOOHOHHHHH
HOOOOOHHOHOOOOHHHOOHHOOOOOOOOOOOHHOOOOOOHHOHOOOOOH
HHHHHOHOOOOHOHHHHHHHHHHOHHHHHOHOHOOHHHOHHOOOOHHHOH
HOOOOOOOHOHHHHOOHHHOOHHHHHHHHOHOHOHHOHOHHOHHHHOHHH
HHHOHHHOHHHOHHHOHOHHOOOOOOOOOOHOHOHOOOOOOOOOOOOOHH
HOOOHHOOOHHOOOOOOOHHHHHOHOHOHOHHHHHHOHOHOHHOHOHOOH
HOHOOHHOHHHOHOHOHOOHHHOOHHHHHHHHOHOOOHOHOHHOHOHOHH
HOHHHHHHHOHHHHHHHHOHOHHHHOOHOOOOOOOHOHOHOOHHHOHHHH
HOHHOHOOOOOHOHOHOOOHOOHHHHOHHHHHHHOHOHOHOHHOOOOOOH
HHHOOHHHHHOOOOOHHHOHOHHOHOOHOHOHOHOHHHHHOOHHOHHHHH
HHHHOOOOOOOHOHOOOOOOOOHOHHOHOHOOOOOHHOHOOHHOOOOOOH
HOOOOHOHHOHHHHHHHHHOHOOOHHOHOOOHOHOOOOHHOHOOHOHHHH
HOHHHHHHOOHHOOOOOOOOHOHOOOOHHHOHOHOHOHHHHHHOHOOOOH
HHHHHOHHHHHHHHHHOHOHHOHHOHOOOOOHOHOHHHHOHOHOHHHOHH
HHHOHOOHHOOOOOOOOHHHHHHHHHHHHHOHOHHHHOOOOOOOOOHOHH
HOOOHHOHOOHHOHOHOHHHOHHOHOHHHHHHOHHHOOHHOHHOHOHOOH
HOHOOOOOOHHHHHOHOHOOOOOOOOOOOOOOOOOHHOHHOHHOHOHHOH
HHHHHHHOHHOHOOOHHHHHHHOHHOHOHHOHOHOOHHHOOOHOHOOHHH
HHOHOOOOHOOOOHOHHOHHOHHHHOHOHHHHOHHHHHHHOHHOHHOHHH
HOOHHHHOHHHHOHHHOOOHOHOOOOHOHOOOOOOHHOHHOHHHHHOOOH
HHOOOHHHHOOHHHHOOHOOOOOHOHHHHHOHHOHHHOOOOOOHHOOHOH
HHHHOHOHOOHHHHOOHHOHHOHHOOOHHOOHOOOOHHHOHOHHOOHHOH
SOOOOOOOOHHHOOOHHHHHHOOHOHOOHHHHHOHHHOOOHOHHOHHOOH
HOHHHHHHOHOOOHOHHOOOOOHHHHHHHHHOOOOOHHOHHOHHOHHOHH
HOHOOOOOOOOHOHOOHHHHHOOHHOOOHOHHHOHHHHOOHOHOOHHOHH
HHHHHHHOHHOHOHOHHOOOOOHHOOHOOOHOOOHHOOOHHHHHOHHOOH
HHOHHHHHHOOHHHOOHHHHHOOHOHHHHOOOHOOHOHOOOOHHHHOOHH
HOOOOOHHHHOHHOOHHHOOOOHHOHOOOOHOHOHHOHHOHOOOHHOHHH
HHHHHOHOHHOOHHHHOOOHHOOHHHHHOHHOHHHOOHHOHOHHHHHHOH
HOHOOOOOOHOHHOOOOHHHHHOHHOHOOHHOOOHOHHHHHOOOOOHHOH
HOHHHHHHOOOOHOHHOOHHOOOHOOOOHHHHOHHOHHOHOOHOHOOOOH
HOOOHOHHHOHHHHHHHHHHHHHHOHOHHHOHOHHHHHOOOHHOHOHOHH
HHHOOOOOOOOHOHHOHOHOHOHOOHOHHOOOOOHHHOOHHHHOHOHOOG
HHOOHOHHOHHHOOOOOOOOOOOOHHOHHHHHOHHOHHOOOOHOHOHOHH
HOOHHOHOOHHHOHHOHOHHHOHOHHOHOOOOOOOOOHOHOHHHHHHHHH
HHOOHHHHOHOOOHHOHHHOOOHOHHOHOHOHOHHOHHHHOOOHOHHHOH
HHOHHHOHHHOHOOHHHHOOHOHOHOOHOHOHOHHOOHHHHHOOOOHOOH
HOOHHOOOOOOHHOOOOHHOHHHHHHOHHHOHOOHOHHOOOHHHHOOOHH
HHOOHHOHHHOHHOHHOHHOOHHOOOOHHOOHHOHOOOOHHHHHHHHOOH
HHOHHOOOHHHHOOHHOHOOHHOOHOHHHHOOHOHHOHOOOOOOOOHHHH
HOOOHHOHHOHHHOHHOHHOHHOHHOHHHHOHHOOHOHHOHHHHOHHHHH
HHOHHOOHOOOOHOOHOHOOOHOHOOOHHOOOHHOHOHHOOOHHOOOOOH
HOOHHHHHHOHOOOHHHHHOHHOHOHOOHHHOHHOHHHHOHHHOOHOHOH
HHOHOOOOOOHHHOOHHOOOHHOHHHOHHOOOHHOOHHOOOHHOHHHHHH
HOOHOHOHOHHOOOHHOOHOHOOHOOOOHHHOOHHOOHHOHHHOHOHOOH
HOHHOHOHOHOOHOOHHOHOHOHHOHOHHOOOHHOOHHOOHHOOOOOOHH
HHHHHHHHHHHHHHHHHHHHHHHHHHHHHHHHHHHHHHHHHHHHHHHHHH
