HHHHHHHHHHHHHHHHHHHH
HOHOHHOOOHHOOGOHHOOH
HOOOOHHHOOHHHOHHOOHH
HHHOHHOHOHHOHOOHHOOH
HOHOHHOHOOOOHHOOHHOH
HOOOOOOHHHHOHHOHHOOH
HOHHHOHHOHOOHHOHHHOH
HHHHOOHHOHOHHOSOHOOH
HHOHHOOOOOOHHHOHHOHH
HOOHHOHHHHOOOOOOOOHH
HHOHHOOOOHOHOHOHHOOH
HHOOOOHOHHOHOHOOHOHH
HOOHHOHOOHOHOHOHHOOH
HHOHHHHHOHOHOHOOHOHH
HOOOOOOHHHOHHHHHHOOH
HHOHHOHHHOOOOHHOOOHH
HOOOHOHHOOHHOHHOHHHH
HHOHHHHHHOHHOHHOOOOH
HOOOOOOHHOHOOOHHOHOH
HHHHHHHHHHHHHHHHHHHH
