OOOOOOGOOH
HHHHHHOHHH
OOOOOOOHOH
OHHHOHHHOH
OHOOOHOOOH
OHOHHHOHHH
OHOHOOOHOH
OHHHOHHHOH
OOOOOOOOOH
HHHHHHHHHH
