OOOOOOOOOH
HHHHOHHHOH
OOOOOHOHGH
OHHHHHOHOH
OHOOOOOOOH
OHOHHHHHOH
OHOOOOOHOH
OHHHHHOHOH
OOOOOOOHOH
HHHHHHHHHH
