OOOHOOOOOH
HHOHOHHHOH
OOOHOHOOOH
OHHHOHHHOH
OOOHSOOHOH
HHOHHHHHOH
OOOHOOOOOH
OHHHOHHHHH
OOOOOOGOOH
HHHHHHHHHH
