OOOOOOOHOOOH
OHOHHHHHOHOH
OHOHGOOOOHOH
HHOHOHHHOHOH
OOOHOHOHOOOH
OHHHOHOHHHHH
OOOHOOOOOHOH
OHOHHHHHOHOH
OHOOOHOOOHOH
OHHHOHOHHHOH
OOOHOOOOOOOH
HHHHHHHHHHHH
